15
20
********************
*** ******     *****
*** ****** *********
P               ****  
*** ******     *****
*** ****** *********        
*** *** ******* ****
*** *** ******* ****
*** ******     *****
*** *** ************
*** ****** *********
*** ******     *****
*                  T
********************
********************
