10
20
********************
*** ******     *****
*** ****** *********
***P               *              
*** *** ******* ****
*** *** ******* ****
*** ****** *********
*                  T
********************
********************
