10
25
*************************
*** ******     **********
*** ****** **************
P               *********               
*** *** ******* *********
*** *** ******* *********
*** *** ******* *********
*     *            T*****
*************************
*************************
