10
20
********************
*** ******     *****
*** ****** *********
PT              ****
*** *** ******* ****
*** *** ******* ****
*** *** ************
*     *            *
********************
********************
